b                                                          b
b                                                          b
b                                                          b
b                                                          b
b                                                          b
b                                                          b
b                                                          b
b               12          b                              b
b               34          bb                             b
bh     pp   ubbbbbbbbbbbbbbbbbbbbbbbbbu                    b
bp          u                         u                    b
b p         u                         u                    b
b           u                         u                    b
b   pp      u         ppppp           u                    b
12      pp  pp  12                    u                    b
34             b34b          bbb  bb  bb  bb               b
ggfffffffffffffbbbb          bbbffbbffbbffbb               b
gggggggggggggggggggggggggggggggggggggggggggggggggggggggggggg